NO ./textures/brick1.png
SO ./textures/brick2.png
EA ./textures/brick3.png
WE ./textures/brick4.png

F 128,128,128
C 153,255,255

1111111111
1010000001
1010000001
1010000001
1000000101
1000N00001
1111111111